0000000000000000000000000
3010102010101010101010101
1010301010101020101010101
1010101020103010101010101
3010102010101010102010101


