3010102010101010101010101
1010301010101020101010101
1010101020103010101010101
3010102010101010102010101
1020101010201010101030101
1010101010102030202010101
1020301010201020101010201
1030102020101010202010101
1020102020103020102010101