3010102010101010101010101
1010301010101020101010101
1010101020103010101010101
3010102010101010102010101
1020101010201010101030101
1010101010102030202010101
1020301010201020101010201
1030102020101010202010101
1020102020103020102010101
1020101020201010202010103
3010101010102010102010101
1010101010102020101030101
1010302010101010201010201
1020101010201020201010302
2020101010101020302010101
1010301020101020101010101
1030101010102010202010201
1020101010202020202010301
2020101020301010202010201
1020202020101020302010101
2010102030102010102010102
1010102020102010101020302
1010202020102010201020103
1020102020202010201010103
1010102020101020201020103
3020102010202010102010101
1010301010201010201020201
1030102020201020101020102
1030101010102010202020102
2020102020201010201010103
1020302010102010102010101
1010102010202010202030201
1010101010203020202010201
1020101010101010202020203
2010202020101010202010103
1020102020101010202020103
1010102010202010102030201
2020101020101010201010203
3010201020202010201010201
1010202010202010102030201